It's finally here. The news channels have stopped broadcasting. Every person is finding their way to the place they want to be when it happens. The notifications on your phone haven't stopped since the news broke, as friends and family send you the last thoughts they want to share before they no longer can. 

Your apartment doesn't feel the same anymore. 
The  windows  locked, curtains drawn. You're overwhelmed with dread at the thought of opening them. Glancing toward the kitchen table your eyes rest on your grandmother's  tea set . 
You feel  broken-hearted  at the sight and consider how she might have handled this situation. You realize you don't have to wonder. She likely would have handled this the same way she handled her passing. She would have sipped her tea and waited for her time to come, humming hymns all the while. 
You notice your friend  Betsy . Her presence puts you  at ease  and you consider approaching her to talk. 

 You know your time is limited so you decide to spend it with care.

Go Down Together
An Interactive Fiction by Kiersten
Release 1 / Serial number 210904 / Inform 7 build 6M62 (I6/v6.33 lib 6/12N) SD

dining room
You sit at a table in a small dining room with your best friend, Betsy, sitting across from you.

There is a small window locked shut. It looks like it hasn't been opened in years.

Betsy sits quietly at the table. She stares off into the distance looking lost in thought. Betsy sips her tea and lets out a short sigh.

You can also see a tea set (in which is a tea cup) here.

>look
Winding Street

>look
Dining room
You see an old table that belonged to your grandmother. A tea set is laid out on the table. You can smell the faint aroma of jasmine. The steam rises off of the cup.

* * *

>look at tea set
A hand-me-down tea set your grandma gave you for your birthday. You fixate on the fine paintings and details in the set, noticing the depictions of story book animals playing in the forest. 

 The imagery makes you long to  look at the window  and admire the nature around you. You look up to see Betsy eagerly waiting for you to  take the tea cup   and pour her some.

In the tea set is a tea cup.

>take tea cup
You pour the tea from the kettle filling both cups. You gently lift the second cup of tea and hand it to Betsy. 

The wait is finally over, Betsy says enthusiastically. There's no one else I'd rather share it with. 
She holds out the decorative porcelain cup toward the center of the table. 
 "A toast to the end." 
 "A toast to the end" you reply. 
Betsy takes a drink of the tea and smiles.  
You hold the warm tea eager to take a  drink . You're excited to  ask Betsy  what she thinks   about the tea  .

>drink tea
(the tea set)
You can smell the faint aroma of jasmine. The steam rises off of the cup.  the tea tastes herbal and delicious.

>look at window
You gaze out of the window. You stare into the desolate landscape that was once a flourishing garden years ago. 
The thick wall of polluted fog makes it impossible to see what may be in the distance. The crystal clear blue sky you remembered as a child is painted with toxic hues of grey and orange. 
Your chest tightens and your heart begins to sink.  
Betsy, noticing your despondent expression, gets up from her chair. 
She places her hand on your shoulder and says: "I know what you're feeling. Let's make this day the best we can."

>open window
You place your fingers on the window locks. 
 Betsy jumps from her seat. "Woah hey! What are you doing!?" she exclaims. 
 You jolt back, retracting your hands from the window. 

 You feel like you should  tell Betsy sorry  for scaring her.

>sorry
"I'm sorry I don't know what came over me. I didn't mean to worry you, it must be an old hab"- "hey you have nothing to apologize for" she interjects. 
What matters is that we're okay. This tea you made will make up for it" she laughs.  
 Betsy's light hearted response brings you back to a calmer place.  You look up from the table and give a warm "thanks."

>ask betsy about tea
"How is the tea?" You ask. 
"Perfect. Even better than I expected. I've been thinking about it since the day we decided to store it." Betsy says joyfully, her smile beaming as she takes another sip. 
 "What do you think? Do you like it? She asks." 

 (Yes/No).

>yes
"Yes. I love it!" 
 "I knew you would," said Betsy. "I'm going to miss stopping at that tea shop downtown on the way to class with you. That was one of my fondest memories. You helped me out through some tough times. 
I don't know how I could've made it without you."  
 "I feel the same way, I miss it all so much," you say, your eyes filling with tears. "thanks for always being there." 

The light outside the window gets brighter and begins to fill the room. 
You and Betsy look at another knowingly. The moment has come. 
As you meet for one last embrace you remember the life you lived and how grateful you are to have had someone special to share in those moments with you.

    *** You have completed the game ***

Would you like to RESTART, RESTORE a saved game, QUIT, or UNDO the last command?

>restart
It's finally here. The news channels have stopped broadcasting. Every person is finding their way to the place they want to be when it happens. The notifications on your phone haven't stopped since the news broke, as friends and family send you the last thoughts they want to share before they no longer can. 

Your apartment doesn't feel the same anymore. 
The  windows  locked, curtains drawn. You're overwhelmed with dread at the thought of opening them. Glancing toward the kitchen table your eyes rest on your grandmother's  tea set . 
You feel  broken-hearted  at the sight and consider how she might have handled this situation. You realize you don't have to wonder. She likely would have handled this the same way she handled her passing. She would have sipped her tea and waited for her time to come, humming hymns all the while. 
You notice your friend  Betsy . Her presence puts you  at ease  and you consider approaching her to talk. 

 You know your time is limited so you decide to spend it with care.

Go Down Together
An Interactive Fiction by Kiersten
Release 1 / Serial number 210904 / Inform 7 build 6M62 (I6/v6.33 lib 6/12N) SD

dining room
You sit at a table in a small dining room with your best friend, Betsy, sitting across from you.

There is a small window locked shut. It looks like it hasn't been opened in years.

Betsy sits quietly at the table. She stares off into the distance looking lost in thought.

You can also see a tea set (in which is a tea cup) here.

>throw tea
(the tea set)
 To throw the tea set  try instead "throw the tea set AT something."

>throw tea at table
(the tea set at the table)
Why would you do that?

(first taking the tea set)
You should probably  take the tea cup  out of the tea set first.

>throw tea at betsy
(the tea set at Betsy)
Why would you do that?

(first taking the tea set)
You should probably  take the tea cup  out of the tea set first.

>pour tea
(the tea set)
You should probably  take the tea cup  out of the tea set first.

>take tea cup
You pour the tea from the kettle filling both cups. You gently lift the second cup of tea and hand it to Betsy. 

The wait is finally over, Betsy says enthusiastically. There's no one else I'd rather share it with. 
She holds out the decorative porcelain cup toward the center of the table. 
 "A toast to the end." 
 "A toast to the end" you reply. 
Betsy takes a drink of the tea and smiles.  
You hold the warm tea eager to take a  drink . You're excited to  ask Betsy  what she thinks   about the tea  .

* * *

>look at tea set
A hand-me-down tea set your grandma gave you for your birthday. You fixate on the fine paintings and details in the set, noticing the depictions of story book animals playing in the forest. 

 The imagery makes you long to  look at the window  and admire the nature around you. You look up to see Betsy eagerly waiting for you to  take the tea cup   and pour her some.

In the tea set is a tea cup.

>pour tea
You must supply a noun.

>take tea
Taken.

>pour tea
You must supply a noun.

* * *

>look at tea set
A hand-me-down tea set your grandma gave you for your birthday. You fixate on the fine paintings and details in the set, noticing the depictions of story book animals playing in the forest. 

 The imagery makes you long to  look at the window  and admire the nature around you. You look up to see Betsy eagerly waiting for you to  take the tea cup   and pour her some.

In the tea set is a tea cup.

>take tea set
Taken.

>pour tea
You must supply a noun.

* * *

>look at tea set
A hand-me-down tea set your grandma gave you for your birthday. You fixate on the fine paintings and details in the set, noticing the depictions of story book animals playing in the forest. 

 The imagery makes you long to  look at the window  and admire the nature around you. You look up to see Betsy eagerly waiting for you to  take the tea cup   and pour her some.

In the tea set is a tea cup.

>look at tea cup
You can't see any such thing.

>drink tea
the tea tastes herbal and delicious.

>open window
Betsy gets up from her seat and exclaims what are you doing?! You take a step back and say: sorry old habit I guess.

>look at dining room
You can't see any such thing.

>look at window
a small wondow locked shut, it looks like it hasn't been opened in years.

>look at betsy
Besty is your best friend. You feel less alone with her here.

>tell betsy yes
She looks interested.

>tell betsy no
She looks annoyed.

>tell betsy sorry
She looks bored.

>ask betsy who she is
"you've known me since school."

>ask betsy what her favorite animal is
"I love dogs!"

>ask betsy what she is
"Nothing in particular."

>ask betsy about the weather
Betsy looks blank, appalled by a question for which she was not prepared.

    *** You finished the game! ***

Would you like to RESTART, RESTORE a saved game, QUIT or UNDO the last command?

>tell betsy hello
Please give one of the answers above.

Would you like to RESTART, RESTORE a saved game, QUIT or UNDO the last command?

>restart
"Oh, you've arrived," says Betsy.

Go Down Together
An Interactive Fiction by Kiersten
Release 1 / Serial number 210902 / Inform 7 build 6M62 (I6/v6.33 lib 6/12N) SD

dining room
You sit at a table in a small dining room with your best friend, Betsy, sitting across from you.

The window shows the outside world.

Betsy sits quietly at the table. She stares off into the distance looking lost in thought.

You can also see a tea set here.

>tell betsy hello
Betsy looks blank, appalled by a question for which she was not prepared.

    *** You finished the game! ***

Would you like to RESTART, RESTORE a saved game, QUIT or UNDO the last command?

>ask betsy how she is doing
Please give one of the answers above.

Would you like to RESTART, RESTORE a saved game, QUIT or UNDO the last command?

>restart
"Oh, you've arrived," says Betsy.

Go Down Together
An Interactive Fiction by Kiersten
Release 1 / Serial number 210902 / Inform 7 build 6M62 (I6/v6.33 lib 6/12N) SD

dining room
You sit at a table in a small dining room with your best friend, Betsy, sitting across from you.

The window shows the outside world.

Betsy sits quietly at the table. She stares off into the distance looking lost in thought.

You can also see a tea set here.

>ask betsy how she is doing
"I've been better."

* * *

>look at tea set
A hand-me-down tea set your grandma gave you for your birthday. You fixate on the fine paintings and details in the set, noticing the depictions of story book animals playing in the forest. 

 The imagery makes you long to  look at the window  and admire the nature around you. You look up to see Betsy eagerly waiting for you to  take the tea cup   and pour her some.

In the tea set is a tea cup.

>take tea
Taken.

>take tea cup
I only understood you as far as wanting to take the tea set.

>look at tea
A hand-me-down tea set your grandma gave you for your birthday. You fixate on the fine paintings and details in the set, noticing the depictions of story book animals playing in the forest.

>look at tea cup
You can't see any such thing.

>look at the tea cup
You can't see any such thing.

* * *

>look at table
An antique table is next to a window.

* * *

>look at Betsy
Besty is your best friend.

* * *

>ask Betsy about The tea set
Betsy smiles a little and says: I'm glad we could use this set one last time. You even made Jasmine tea, my favorite.

* * *

>ask Betsy about tea
There is no reply.

* * *

>ask betsy about the tea
"How is the tea?" You ask. 

"Perfect. Even better than I expected. I've been thinking about it since the day we decided to store it. Betsy says joyfully, her smile beaming as she takes another sip. 

 "What do you think? Do you like it? She asks."  (Yes/No).

>ask betsy about the window
Betsy frowns and says: sorry we can't open the window anymore

>ask betsy how are you
I didn't understand that sentence.

>ask betsy about how are you
She looks at her reflection in the tea and says things could be better

* * *

>ask betsy about the tea
"How is the tea?" You ask. 

"Perfect. Even better than I expected. I've been thinking about it since the day we decided to store it. Betsy says joyfully, her smile beaming as she takes another sip. 

 "What do you think? Do you like it? She asks."  (Yes/No).

>no
"I've had better." Betsy looks down a little disappointed. "Well she says, I think there's still a bit of clean water left." You walk over to the small container of water, thinking about how you scraped together the money you had left to buy. 

 Reflecting on the situation causes you to feel dejected. You decide it's better to focus on something else.

>yes
"Yes. I love it!" 

 "I knew you would," said Betsy. "I'm going to miss stopping at that tea shop downtown on the way to class with you. That was one of my fondest memories. You helped me out through some tough times. I don't know how I could've made it without you."  

 "I feel the same way, I miss it all so much," you say your eyes filling with tears. "thanks for always being there."

>look at tea set
A hand-me-down tea set your grandma gave you for your birthday. You fixate on the fine paintings and details in the set, noticing the depictions of story book animals playing in the forest. 

 The imagery makes you long to  look at the window  and admire the nature around you. You look up to see Betsy eagerly waiting for a  cup  .

In the tea set is a tea cup.

>take the tea cup
You pour the tea from the kettle filling both cups. You gently lift the second cup of tea and hand it to Betsy. 

 The wait is finally over, Betsy says enthusiastically. There's no one else I'd rather share it with. She holds out the decorative porcelain cup toward the center of the table. "A toast to the end."  "A toast to the end" you reply. Betsy takes a drink of the tea and smiles.  

 You hold the warm tea eager to take a  drink . You're excited to  ask Betsy what she thinks about the tea  .

>ask betsy what she thinks about the tea
There is no reply.

* * *

>ask Betsy about the tea
Betsy smiles a little and says: I'm glad we could use this set one last time. You even made Jasmine tea, my favorite.

>look at Betsy
Besty is your best friend.

>look at table
An antique table is next to a window.

* * *

>look at the table
An antique table is next to a window. There is a tea set in the middle of the table.

>take tea
(the tea set)
Taken.

>take tea cup
You pour the tea from the kettle filling both cups. You gently lift the second cup of tea and hand it to Betsy. 

 The wait is finally over, Betsy says enthusiastically. There's no one else I'd rather share it with. She holds out the decorative porcelain cup toward the center of the table. "A toast to the end."  "A toast to the end" you reply. Betsy takes a drink of the tea and smiles.  

 You hold the warm tea eager to take a  drink . You're excited to  ask Betsy  what she thinks   about the tea  .

>ask betsy about tea
"How is the tea?" You ask. 

"Perfect. Even better than I expected. I've been thinking about it since the day we decided to store it. Betsy says joyfully, her smile beaming as she takes another sip. 

 "What do you think? Do you like it? She asks."  (Yes/No).

>yes
"Yes. I love it!" 

 "I knew you would," said Betsy. "I'm going to miss stopping at that tea shop downtown on the way to class with you. That was one of my fondest memories. You helped me out through some tough times. I don't know how I could've made it without you."  

 "I feel the same way, I miss it all so much," you say, your eyes filling with tears. "thanks for always being there."

>no
"I've had better." Betsy looks down a little disappointed. "Well she says, I think there's still a bit of clean water left." You walk over to the small container of water, thinking about how you scraped together the little money you had left to get it. 

 Reflecting on the situation causes you to feel dejected. You decide it's better to focus on something else.

>sorry
"I'm sorry I don't know what came over me. I didn't mean to worry you, it must be an old hab"- "hey you have nothing to apologize for" she interjects. What matters is that we're okay. This tea you made will make up for it" she laughs.  

 Betsy's light hearted response brings you back to a calmer place.  You look up from the table and give a warm "thanks."

>look at window
You gaze out of the window. You stare into the desolate landscape that was once a flourishing garden years ago. The thick wall of polluted fog makes it impossible to see what may be in the distance. The crystal clear blue sky you remembered as a child is painted with toxic hues of grey and orange. Your chest tightens and your heart begins to sink.  

Betsy, noticing your despondent expression, gets up from her chair and places her hand on your shoulder. "I know what you're feeling. Let's make this day the best we can."

>open window
You place your fingers on the window locks. 

 Betsy jumps from her seat. "Woah hey! What are you doing!?" she exclaims. 

 You jolt back, retracting your hands from the window. 

 You feel like apologizing to Betsy for scaring her.

>drink tea
(the tea set)
You can smell the faint aroma of jasmine. The steam rises off of the cup.  the tea tastes herbal and delicious.

>look at tea
(the tea set)
A hand-me-down tea set your grandma gave you for your birthday. You fixate on the fine paintings and details in the set, noticing the depictions of story book animals playing in the forest. 

 The imagery makes you long to  look at the window  and admire the nature around you. You look up to see Betsy eagerly waiting for a  cup  .

In the tea set is a tea cup.

>look at betsy
You notice your friend Betsy. Her presence puts you at ease and you consider approaching her to talk.

>talk to betsy
I didn't understand that sentence.

* * *

>drink tea
the tea tastes herbal and delicious.

>look at tea set
In the tea set is a tea cup.

>take tea cup
You can smell the faint aroma of jasmine. The steam rises off of the cup.

>drink tea
(the tea set)
There's nothing suitable to drink here.

>look at tea cup
its a tea cup.

>talk to Betsy
That's not a verb I recognise.

* * *

>drink tea
the tea tastes herbal and delicious.

>look at dining room
You can't see any such thing.

>ask betsy what she is up to
"Nothing in particular."

>ask betsy what she means
"Nothing in particular."

>ask betsy why she is visiting me
"You are my best friend.

>ask betsy what is up
Betsy looks blank, appalled by a question for which she was not prepared.

    *** You finished the game! ***

Would you like to RESTART, RESTORE a saved game, QUIT or UNDO the last command?

* * *

>talk to Betsy
I didn't understand that sentence.

>open window
You open the window, revealing an outside air.

* * *

>talk to Betsy
I didn't understand that sentence.

>Talk to Betsy about the tea
Betsy looks blank, appalled by a question for which she was not prepared.

    *** You finished the game! ***

Would you like to RESTART, RESTORE a saved game, QUIT, or UNDO the last command?

* * *

>open the window
You place your fingers on the window locks. Betsy jumps from her seat. "Woah hey! What are you doing!?" she exclaims. You jolt back, retracting your hands from the window. 

 You feel like apologizing to Betsy for scaring her.

>look at window
a small wondow locked shut, it looks like it hasn't been opened in years.

In the window is an outside air.

* * *

>open window
You place your fingers on the window locks. 

 Betsy jumps from her seat. "Woah hey! What are you doing!?" she exclaims. 

 You jolt back, retracting your hands from the window. 

 You feel like you should  tell Betsy sorry  for scaring her.

>tell betsy sorry
"I'm sorry I don't know what came over me. I didn't mean to worry you, it must be an old hab"- "hey you have nothing to apologize for" she interjects. What matters is that we're okay. This tea you made will make up for it" she laughs.  

 Betsy's light hearted response brings you back to a calmer place.  You look up from the table and give a warm "thanks."

>pour the tea
(the tea set)
Taken.

* * *

>how have things been
That's not a verb I recognise.

>talk to Betsy
That's not a verb I recognise.

* * *

>ask Betsy
What do you want to ask Betsy for?

>how have things been
You can't see any such thing.

>ask Betsy how have things been
I didn't understand that sentence.

>ask betsy
What do you want to ask Betsy for?

>tea
(the tea set)
(Betsy first taking the tea set)
Betsy has better things to do.

>talk to betsy
That's not a verb I recognise.

>ask betsy how have things been
I didn't understand that sentence.

* * *

>ask betsy how have things been
I didn't understand that sentence.

* * *

>ask betsy about how are you
things could be better

>ask betsy how are oyu
I didn't understand that sentence.

>ask betsy how are you
I didn't understand that sentence.

* * *

>look at the window
a small wondow locked shut, it looks like it hasn't been opened in years.  

 You gaze out of the window. You stare into the desolate landscape that was once a flourishing garden years ago. The thick wall of polluted fog makes it impossible to see what may be in the distance. The crystal clear blue sky you remembered as a child is painted with toxic hues of grey and orange. Your chest tightens and your heart begins to sink. Betsy, noticing your despondent expression, gets up from her chair and places her hand on your shoulder. "I know what you're feeling. Let's make this day the best we can."

* * *

>open the window
You place your fingers on the window locks. 

 Betsy jumps from her seat. "Woah hey! What are you doing!?" she exclaims. 

 You jolt back, retracting your hands from the window. 

 You feel like apologizing to Betsy for scaring her.

>Tell Betsy sorry
"I'm sorry I don't know what came over me. I didn't mean to worry you, it must be an old hab"- 

 "hey you have nothing to apologize for" she interjects. What matters is that we're okay. I can't exactly expect anyone to be in the best headspace. This tea you made will make up for it" she laughs.  

 Betsy's light hearted response brings you back to a calmer place.  You look up from the table and give a warm "thanks."

>look at window
You gaze out of the window. You stare into the desolate landscape that was once a flourishing garden years ago. The thick wall of polluted fog makes it impossible to see what may be in the distance. The crystal clear blue sky you remembered as a child is painted with toxic hues of grey and orange. Your chest tightens and your heart begins to sink.  

Betsy, noticing your despondent expression, gets up from her chair and places her hand on your shoulder. "I know what you're feeling. Let's make this day the best we can."

>look at  the tea set
A hand-me-down tea set your grandma gave you for your birthday. You fixate on the fine paintings and details in the set, noticing the depictions of story book animals playing in the forest.

In the tea set is a tea cup.

>drink tea
(the tea set)
You can smell the faint aroma of jasmine. The steam rises off of the cup.  the tea tastes herbal and delicious.

>ask betsy about the tea
Betsy smiles a little and says: I'm glad we could use this set one last time. You even made Jasmine tea, my favorite.

* * *

>open the window
You place your fingers on the window locks. 

 Betsy jumps from her seat. "Woah hey! What are you doing!?" she exclaims. 

 You jolt back, retracting your hands from the window. 

 You feel like apologizing to Betsy for scaring her.

>tell betsy sorry
"I'm sorry I don't know what came over me. I didn't mean to worry you, it must be an old hab"- "hey you have nothing to apologize for" she interjects. What matters is that we're okay. I can't exactly expect anyone to be in the best headspace. This tea you made will make up for it" she laughs.  

 Betsy's light hearted response brings you back to a calmer place.  You look up from the table and give a warm "thanks."

>look at window
You gaze out of the window. You stare into the desolate landscape that was once a flourishing garden years ago. The thick wall of polluted fog makes it impossible to see what may be in the distance. The crystal clear blue sky you remembered as a child is painted with toxic hues of grey and orange. Your chest tightens and your heart begins to sink.  

Betsy, noticing your despondent expression, gets up from her chair and places her hand on your shoulder. "I know what you're feeling. Let's make this day the best we can."

* * *

>ask betsy sup
I didn't understand that sentence.

>ask betsy about eggs
Betsy looks at you with a confused expression.

>look at tea cup
its a tea cup.

* * *

>look at the set
You fixate on the fine paintings and details in the set, noticing the depictions of story book animals playing in the forest .

In the tea set is a tea cup.

>look at the tea cup
its a tea cup.

>pour tea
That's not a verb I recognise.

* * *

>pur tea
That's not a verb I recognise.

>pour tea
You must supply a noun.

* * *

>pour
I didn't understand that sentence.

>pour tea
You must supply a noun.

* * *

>pour
I didn't understand that sentence.

>pour the tea
You must supply a noun.

>ask the tea
You can only do that to something animate.

>take the tea
Taken.

>pour the tea
You must supply a noun.

* * *

>pour the tea
(the tea set)
You should probably  take the tea cup  out first.

>drink the tea
(the tea set)
You can smell the faint aroma of jasmine. The steam rises off of the cup.  the tea tastes herbal and delicious.

>look at the window
a small wondow locked shut, it looks like it hasn't been opened in years.

>tell betsy yes
She looks interested.

>open the window
Betsy gets up from her seat and exclaims what are you doing?! You take a step back and say: sorry old habit I guess.

* * *

>pour the tea
(the tea set)
You should probably  take the tea cup  out first.

>pour the tea cup
That's not a verb I recognize.

* * *

>pour the tea
(the tea set)
You should probably  take the tea cup  out first.

>take tea cup
You pour the tea from the kettle filling both cups. You gently lift the second cup of tea and hand it to Betsy. 

 The wait is finally over, Betsy says enthusiastically. There's no one else I'd rather share it with. She holds out the decorative porcelain cup toward the center of the table. "A toast to the end."  "A toast to the end" you reply. Betsy takes a drink of the tea and smiles.  

 You hold the warm tea eager to take a  drink . You're excited to  ask Betsy  what she thinks   about the tea  .

>look at tea set
A hand-me-down tea set your grandma gave you for your birthday. You fixate on the fine paintings and details in the set, noticing the depictions of story book animals playing in the forest. 

 The imagery makes you long to  look at the window  and admire the nature around you. You look up to see Betsy eagerly waiting for a  cup  .

In the tea set is a tea cup.

>look at the window
You gaze out of the window. You stare into the desolate landscape that was once a flourishing garden years ago. The thick wall of polluted fog makes it impossible to see what may be in the distance. The crystal clear blue sky you remembered as a child is painted with toxic hues of grey and orange. Your chest tightens and your heart begins to sink.  

Betsy, noticing your despondent expression, gets up from her chair and places her hand on your shoulder. "I know what you're feeling. Let's make this day the best we can."

>look at window
You gaze out of the window. You stare into the desolate landscape that was once a flourishing garden years ago. The thick wall of polluted fog makes it impossible to see what may be in the distance. The crystal clear blue sky you remembered as a child is painted with toxic hues of grey and orange. Your chest tightens and your heart begins to sink.  

Betsy, noticing your despondent expression, gets up from her chair and places her hand on your shoulder. "I know what you're feeling. Let's make this day the best we can."

>drink tea
(the tea set)
You can smell the faint aroma of jasmine. The steam rises off of the cup.  the tea tastes herbal and delicious.

>open window
You place your fingers on the window locks. 

 Betsy jumps from her seat. "Woah hey! What are you doing!?" she exclaims. 

 You jolt back, retracting your hands from the window. 

 You feel like you should  tell Betsy sorry  for scaring her.

* * *

>tell betsy sorry
"I'm sorry I don't know what came over me. I didn't mean to worry you, it must be an old hab"- "hey you have nothing to apologize for" she interjects. What matters is that we're okay. This tea you made will make up for it" she laughs.  

 Betsy's light hearted response brings you back to a calmer place.  You look up from the table and give a warm "thanks."

>apologize to betsy
That's not a verb I recognize.

* * *

>pour tea
You must supply a noun.

>pur
That's not a verb I recognise.

>pour
I didn't understand that sentence.

* * *

>look at the tea set
A hand-me-down tea set your grandma gave you for your birthday. You fixate on the fine paintings and details in the set, noticing the depictions of story book animals playing in the forest. 

 The imagery makes you long to  look outside  and admire the nature around you. You look up to see Betsy eagerly waiting for a  cup  .

In the tea set is a tea cup.

>pour the tea set
You must supply a noun.

* * *

>look at the tea set
A hand-me-down tea set your grandma gave you for your birthday. You fixate on the fine paintings and details in the set, noticing the depictions of story book animals playing in the forest. 

 The imagery makes you long to  look outside  and admire the nature around you. You look up to see Betsy eagerly waiting for a  cup  .

In the tea set is a tea cup.

>look at the tea cup
It's difficult to think about the years you spent with Nana. Given everything that's happening, you can't help but feel nostalgic for the times before. It's difficult, but you consider spending your time reminiscing about the past. At the same time, you realize you aren't as affected by the sight of the set as you would have thought. You feel empty like the cup. You consider making yourself one final cup.

>pour tea
That's not a verb I recognize.

>drink tea
(the tea set)
You can smell the faint aroma of jasmine. The steam rises off of the cup.  the tea tastes herbal and delicious.

>take the tea cup
It's difficult to think about the years you spent with Nana. Given everything that's happening, you can't help but feel nostalgic for the times before. It's difficult, but you consider spending your time reminiscing about the past. At the same time, you realize you aren't as affected by the sight of the set as you would have thought. You feel empty like the cup. You consider making yourself one final cup.

* * *

>look at the tea set
A hand-me-down tea set your grandma gave you for your birthday. You fixate on the fine paintings and details in the set, noticing the depictions of story book animals playing in the forest. 

 The imagery makes you long to  look outside  and admire the nature around you. You look up to see Betsy eagerly waiting for a  cup  .

In the tea set is a tea cup.

>take the tea cup
You pour the tea from the kettle filling both cups. You gently lift the second cup of tea and hand it to Betsy.

>drink the tea
(the tea set)
You can smell the faint aroma of jasmine. The steam rises off of the cup.  the tea tastes herbal and delicious.

* * *

>tell betsy hi
I didn't understand that sentence.

* * *

>yes
That was a rhetorical question.

>no
That was a rhetorical question.

>sorry
Oh, don't apologise.

* * *

>tell betsy how are you
There is no reply.

>ask betsy how are you
I didn't understand that sentence.

* * *

>tell betsy yes
That was a rhetorical question.

>ask betsy yes
I didn't understand that sentence.

>tell betsy ssorry
There is no reply.

* * *

>ask betsy about the world
The Sybil declaims for a while, the gist being that the muse in question looks after epic poetry.

* * *

>ask betsy about outside
Betsy looks down at her tea and shakes her head. I really miss being able to go outside. It's been so long..

>ask betsy about the tea
Betsy smiles a little and says: I'm glad we could use this set one last time. You even made Jasmine tea, my favorite.

>open the window
Betsy gets up from her seat and exclaims what are you doing?! You take a step back and say: sorry old habit I guess.

>look at the window
a small wondow locked shut, it looks like it hasn't been opened in years.

>look outside
You see nothing unexpected in that direction.

>how are you
That's not a verb I recognise.

>ask betsy about how are you
She looks at her reflection in the tea and says things could be better

>ask betsy about how she is doing
Betsy looks at you with a confused expression.

>ask betsy about the tea set
This is my favorite tea set, she says enthusiastically

>ask betsy about the dining roo,
Betsy looks at you with a confused expression.

>ask betsy about the dining room
There's no place I would rather be

* * *

>ask betsy what rain is
Betsy looks at you with a confused expression.

>ask betsy about the world
Betsy looks down at her tea and shakes her head. Maybe we shouldn't talk about that right now. Let's focus on something else for a while. .

* * *

>ask betsy about rain
Betsy looks blank, appalled by a question for which she was not prepared.

    *** You finished the game! ***

Would you like to RESTART, RESTORE a saved game, QUIT or UNDO the last command?

>restart
"Oh, you've arrived," says Betsy.

Go Down Together
An Interactive Fiction by Kiersten
Release 1 / Serial number 210902 / Inform 7 build 6M62 (I6/v6.33 lib 6/12N) SD

dining room
You sit at a table in a small dining room with your best friend, Betsy, sitting across from you.

The window shows the outside world.

Betsy sits quietly at the table. She stares off into the distance looking lost in thought.

You can also see a tea set here.

>ask betsy what rain is
"Clouds are a disturbance made by the paths of birds," Solomon replies. "The air beaten by their wings becomes agitated, as when a river is stirred and the mud churns up."

>ask betsy where rain is
"Weather is contained in a great silk bag which holds in the heavens," replies Solomon.

>ask betsy what weather is
"Clouds are a disturbance made by the paths of birds," Solomon replies. "The air beaten by their wings becomes agitated, as when a river is stirred and the mud churns up."

Betsy hears ya.

    *** Your heart beats strangely fast ***

Would you like to RESTART, RESTORE a saved game, QUIT or UNDO the last command?

>restart
"Oh, you've arrived," says Betsy.

Go Down Together
An Interactive Fiction by Kiersten
Release 1 / Serial number 210902 / Inform 7 build 6M62 (I6/v6.33 lib 6/12N) SD

dining room
You sit at a table in a small dining room with your best friend, Betsy, sitting across from you.

The window shows the outside world.

Betsy sits quietly at the table. She stares off into the distance looking lost in thought.

You can also see a tea set here.

* * *

>tell betsy hello
Betsy looks blank, appalled by a question for which she was not prepared.

    *** You finished the game! ***

Would you like to RESTART, RESTORE a saved game, QUIT or UNDO the last command?

>restart
"Oh, you've arrived," says Betsy.

Go Down Together
An Interactive Fiction by Kiersten
Release 1 / Serial number 210902 / Inform 7 build 6M62 (I6/v6.33 lib 6/12N) SD

dining room
You sit at a table in a small dining room with your best friend, Betsy, sitting across from you.

The window shows the outside world.

Betsy sits quietly at the table. She stares off into the distance looking lost in thought.

You can also see a tea set here.

>drink the tea
There's nothing suitable to drink here.

>look at the tea set
You fixate on the fine paintings and details in the set, noticing the depictions of story book animals playing in the forest .

>take the tea set
Taken.

>take the tea sup
I only understood you as far as wanting to take the tea set.

>take the tea cup
I only understood you as far as wanting to take the tea set.

>restart
Are you sure you want to restart?

>yes
"Oh, you've arrived," says Betsy.

Go Down Together
An Interactive Fiction by Kiersten
Release 1 / Serial number 210902 / Inform 7 build 6M62 (I6/v6.33 lib 6/12N) SD

dining room
You sit at a table in a small dining room with your best friend, Betsy, sitting across from you.

The window shows the outside world.

Betsy sits quietly at the table. She stares off into the distance looking lost in thought.

You can also see a tea set here.

* * *

>drink the tea
the tea tastes herbal and delicious.

* * *

>no
"I've had better." 
Betsy looks down a little disappointed. 
"Well she says, I think there's still a bit of clean water left." 
You walk over to the small container of water, thinking about how you scraped together the little money you had left to get it. 
 Reflecting on the situation causes you to feel dejected. You decide it's better to focus on something else.

>yes
"Yes. I love it!" 
 "I knew you would," said Betsy. "I'm going to miss stopping at that tea shop downtown on the way to class with you. That was one of my fondest memories. You helped me out through some tough times. I don't know how I could've made it without you."  
 "I feel the same way, I miss it all so much," you say, your eyes filling with tears. "thanks for always being there."

>sorry
"I'm sorry I don't know what came over me. I didn't mean to worry you, it must be an old hab"- "hey you have nothing to apologize for" she interjects. What matters is that we're okay. This tea you made will make up for it" she laughs.  
 Betsy's light hearted response brings you back to a calmer place.  You look up from the table and give a warm "thanks."

* * *

>ask betsy who she is
"you've known me since school.

>ask betsy what she is
"Nothing in particular."

>ask betsy how she is doing
Betsy looks blank, appalled by a question for which she was not prepared.

    *** You finished the game! ***

Would you like to RESTART, RESTORE a saved game, QUIT or UNDO the last command?

* * *

>ask betsy how she is doing
"I've been better."

>ask betsy what is up
Betsy looks blank, appalled by a question for which she was not prepared.

    *** You finished the game! ***

Would you like to RESTART, RESTORE a saved game, QUIT or UNDO the last command?

>restart
"Oh, you've arrived," says Betsy.

Go Down Together
An Interactive Fiction by Kiersten
Release 1 / Serial number 210902 / Inform 7 build 6M62 (I6/v6.33 lib 6/12N) SD

dining room
You sit at a table in a small dining room with your best friend, Betsy, sitting across from you.

The window shows the outside world.

Betsy sits quietly at the table. She stares off into the distance looking lost in thought.

You can also see a tea set here.

>ask betsy where we are
"We are in the dining room.

>ask betsy how she is doing
"I've been better."

>ask betsy why she is here with me
"You are my best friend.

>ask betsy what she is
"Nothing in particular."

>ask betsy why we are here
Betsy looks blank, appalled by a question for which she was not prepared.

    *** You finished the game! ***

Would you like to RESTART, RESTORE a saved game, QUIT or UNDO the last command?

* * *

>look at tea
You fixate on the fine paintings and details in the set, noticing the depictions of story book animals playing in the forest .

>drink tea
the tea tastes herbal and delicious.

>pour tea
That's not a verb I recognise.

>betsy
That's not a verb I recognise.

>look at betsy
Besty is your best friend. You feel less alone with her here.

>ask betsy how she is doing
"I've been better."

>tell betsy no
She looks annoyed.

>tell betsy yes
She looks interested.

>tell betsy hello
Betsy looks blank, appalled by a question for which she was not prepared.

    *** You finished the game! ***

Would you like to RESTART, RESTORE a saved game, QUIT or UNDO the last command?

* * *

>ask betsy how the tea is
Betsy looks blank, appalled by a question for which she was not prepared.

    *** You finished the game! ***

Would you like to RESTART, RESTORE a saved game, QUIT or UNDO the last command?

>restart
"Oh, you've arrived," says Betsy.

Go Down Together
An Interactive Fiction by Kiersten
Release 1 / Serial number 210902 / Inform 7 build 6M62 (I6/v6.33 lib 6/12N) SD

dining room
You sit at a table in a small dining room with your best friend, Betsy, sitting across from you.

The window shows the outside world.

Betsy sits quietly at the table. She stares off into the distance looking lost in thought.

You can also see a tea set here.

>ask betsy about the world
Betsy looks blank, appalled by a question for which she was not prepared.

    *** You finished the game! ***

Would you like to RESTART, RESTORE a saved game, QUIT or UNDO the last command?

>restart
"Oh, you've arrived," says Betsy.

Go Down Together
An Interactive Fiction by Kiersten
Release 1 / Serial number 210902 / Inform 7 build 6M62 (I6/v6.33 lib 6/12N) SD

dining room
You sit at a table in a small dining room with your best friend, Betsy, sitting across from you.

The window shows the outside world.

Betsy sits quietly at the table. She stares off into the distance looking lost in thought.

You can also see a tea set here.

>ask betsy how the world is
Betsy looks blank, appalled by a question for which she was not prepared.

    *** You finished the game! ***

Would you like to RESTART, RESTORE a saved game, QUIT or UNDO the last command?

>restart
"Oh, you've arrived," says Betsy.

Go Down Together
An Interactive Fiction by Kiersten
Release 1 / Serial number 210902 / Inform 7 build 6M62 (I6/v6.33 lib 6/12N) SD

dining room
You sit at a table in a small dining room with your best friend, Betsy, sitting across from you.

The window shows the outside world.

Betsy sits quietly at the table. She stares off into the distance looking lost in thought.

You can also see a tea set here.

>ask betsy what she is
"Nothing in particular."

>ask betsy when the world will end
Betsy looks blank, appalled by a question for which she was not prepared.

    *** You finished the game! ***

Would you like to RESTART, RESTORE a saved game, QUIT or UNDO the last command?

>restayr
Please give one of the answers above.

Would you like to RESTART, RESTORE a saved game, QUIT or UNDO the last command?

>restard
Please give one of the answers above.

Would you like to RESTART, RESTORE a saved game, QUIT or UNDO the last command?

>restart
"Oh, you've arrived," says Betsy.

Go Down Together
An Interactive Fiction by Kiersten
Release 1 / Serial number 210902 / Inform 7 build 6M62 (I6/v6.33 lib 6/12N) SD

dining room
You sit at a table in a small dining room with your best friend, Betsy, sitting across from you.

The window shows the outside world.

Betsy sits quietly at the table. She stares off into the distance looking lost in thought.

You can also see a tea set here.

>ask betsy who she is
"you've known me since school."

>ask how the world is
You can't see any such thing.

>ask when the world ends
You can't see any such thing.

>ask betsy when the word
Betsy looks blank, appalled by a question for which she was not prepared.

    *** You finished the game! ***

Would you like to RESTART, RESTORE a saved game, QUIT or UNDO the last command?

>restart
"Oh, you've arrived," says Betsy.

Go Down Together
An Interactive Fiction by Kiersten
Release 1 / Serial number 210902 / Inform 7 build 6M62 (I6/v6.33 lib 6/12N) SD

dining room
You sit at a table in a small dining room with your best friend, Betsy, sitting across from you.

The window shows the outside world.

Betsy sits quietly at the table. She stares off into the distance looking lost in thought.

You can also see a tea set here.

* * *

>ask betsy how she is doing
"I've been better."

>ask besty about me
You can't see any such thing.

>ask betsy why she is here with me
"You are my best friend.

>ask betsy how she is doing
"I've been better."

>ask betsy when time up
Betsy looks blank, appalled by a question for which she was not prepared.

    *** You finished the game! ***

Would you like to RESTART, RESTORE a saved game, QUIT or UNDO the last command?

>restart
"Oh, you've arrived," says Betsy.

Go Down Together
An Interactive Fiction by Kiersten
Release 1 / Serial number 210902 / Inform 7 build 6M62 (I6/v6.33 lib 6/12N) SD

dining room
You sit at a table in a small dining room with your best friend, Betsy, sitting across from you.

The window shows the outside world.

Betsy sits quietly at the table. She stares off into the distance looking lost in thought.

You can also see a tea set here.

* * *

>ask betsy where we are
"We are in the dining room.

>ask besty how she is doing
You can't see any such thing.

>ask betsy how she is doing
"I've been better."

>ask betsy what she is
"Nothing in particular."

>ask betsy how the tea is
Betsy looks blank, appalled by a question for which she was not prepared.

    *** You finished the game! ***

Would you like to RESTART, RESTORE a saved game, QUIT or UNDO the last command?

* * *

>restart
"Oh, you've arrived," says Betsy.

Go Down Together
An Interactive Fiction by Kiersten
Release 1 / Serial number 210902 / Inform 7 build 6M62 (I6/v6.33 lib 6/12N) SD

dining room
You sit at a table in a small dining room with your best friend, Betsy, sitting across from you.

The window shows the outside world.

Betsy sits quietly at the table. She stares off into the distance looking lost in thought.

You can also see a tea set here.

>ask betsy how the tea is
Betsy looks blank, appalled by a question for which she was not prepared.

    *** You finished the game! ***

Would you like to RESTART, RESTORE a saved game, QUIT or UNDO the last command?

* * *

>ask betsy what her favorite animal is
"I love dogs! 

 you wonder... 

 What breed of dog? 

 what color dog? 

 what size dog? "

>ask betsy what her favorite color is
"I love the color blue."

>ask betsy why she is here with me
"You are my best friend.

>ask betsy where we are
"We are in the dining room.

>ask betsy who she is
"you've known me since school."

>ask betsy how she is
"I've been better."

>ask betsy what she is
"Nothing in particular."

>ask betsy when the world end
Betsy looks blank, appalled by a question for which she was not prepared.

    *** You finished the game! ***

Would you like to RESTART, RESTORE a saved game, QUIT or UNDO the last command?

* * *

>ask betsy what her favorite animal is
"I love dogs! 

 you wonder... 

 What breed of dog? 

 what color dog? 

 what size dog? "

>ask betsy what breed of dog
She smiles and says: "I like golden retrievers!"

* * *

>ask betsy what her favorite animal is
"I love dogs! 

 you wonder... 

 What breed of dog? 

 what color dog? 

 what size dog? "

>ask betsy what Breed of dog
She smiles and says: "I like golden retrievers!"

>ask betsy why she is here with me
"You are my best friend.

Betsy hears ya.

    *** You have a deep appriciation for the time you spent here ***

Would you like to RESTART, RESTORE a saved game, QUIT, or UNDO the last command?

* * *

>ask betsy when time is up
"Not sure, but probably in a few minutes at this rate.

>ashy betsy why she is here
That's not a verb I recognise.

>look at tea
You fixate on the fine paintings and details in the set, noticing the depictions of story book animals playing in the forest .

* * *

>drink tea
the tea tastes herbal and delicious.

>look at betsy
Besty is your best friend. You feel less alone with her here.

* * *

>ask betsy what her favorite animal is
"I love dogs! 

 you wonder... 

 What breed of dog? 

 what color dog? 

 what size dog? "

>ask betsy what breed of dog
"I like golden retriever."

* * *

>drink table
the tea tastes herbal and delicious.

>drink tea
the tea tastes herbal and delicious.

>look at tea cup
You can't see any such thing.

>look at the tea
A hand-me-down tea set your grandma gave you for your birthday. You fixate on the fine paintings and details in the set, noticing the depictions of story book animals playing in the forest.

* * *

>sorry
You have nothing to apologize for.

>tell betsy sorry
You have nothing to apologize for.

* * *

>look outside
You see nothing unexpected in that direction.

>look at outside
You see nothing unexpected in that direction.

* * *

>look out the window
I only understood you as far as wanting to look outside.

>look outside
You see nothing unexpected in that direction.

>look at window
You gaze out of the window. You stare into the desolate landscape that was once a flourishing garden years ago. The thick wall of polluted fog makes it impossible to see what may be in the distance. The crystal clear blue sky you remembered as a child is painted with toxic hues of grey and orange. Your chest tightens and your heart begins to sink.  

Betsy, noticing your despondent expression, gets up from her chair and places her hand on your shoulder. "I know what you're feeling. Let's make this day the best we can."

* * *

>look at outside
You see nothing unexpected in that direction.

>look outside
You see nothing unexpected in that direction.

* * *

>take the tea cup
You pour the tea from the kettle filling both cups. You gently lift the second cup of tea and hand it to Betsy. 

The wait is finally over, Betsy says enthusiastically. There's no one else I'd rather share it with. 
She holds out the decorative porcelain cup toward the center of the table. 
 "A toast to the end." 
 "A toast to the end" you reply. 
Betsy takes a drink of the tea and smiles.  
You hold the warm tea eager to take a  drink . You're excited to  ask Betsy  what she thinks   about the tea  .

>look at the table
An antique table is next to a window. There is a tea set in the middle of the table.

>look at the window
You gaze out of the window. You stare into the desolate landscape that was once a flourishing garden years ago. The thick wall of polluted fog makes it impossible to see what may be in the distance. The crystal clear blue sky you remembered as a child is painted with toxic hues of grey and orange. Your chest tightens and your heart begins to sink.  

Betsy, noticing your despondent expression, gets up from her chair and places her hand on your shoulder. "I know what you're feeling. Let's make this day the best we can."

>open the window
You place your fingers on the window locks. 

 Betsy jumps from her seat. "Woah hey! What are you doing!?" she exclaims. 

 You jolt back, retracting your hands from the window. 

 You feel like apologizing to Betsy for scaring her.

>sorry
"I'm sorry I don't know what came over me. I didn't mean to worry you, it must be an old hab"- "hey you have nothing to apologize for" she interjects. What matters is that we're okay. I can't exactly expect anyone to be in the best headspace. This tea you made will make up for it" she laughs.  

 Betsy's light hearted response brings you back to a calmer place.  You look up from the table and give a warm "thanks."

>look at betsy
You notice your friend Betsy. Her presence puts you at ease and you consider approaching her to talk.

>look at tea set
A hand-me-down tea set your grandma gave you for your birthday. You fixate on the fine paintings and details in the set, noticing the depictions of story book animals playing in the forest. 

 The imagery makes you long to  look at the window  and admire the nature around you. You look up to see Betsy eagerly waiting for a  cup  .

In the tea set is a tea cup.

>look at window
You gaze out of the window. You stare into the desolate landscape that was once a flourishing garden years ago. The thick wall of polluted fog makes it impossible to see what may be in the distance. The crystal clear blue sky you remembered as a child is painted with toxic hues of grey and orange. Your chest tightens and your heart begins to sink.  

Betsy, noticing your despondent expression, gets up from her chair and places her hand on your shoulder. "I know what you're feeling. Let's make this day the best we can."

>ask betsy about the tea
Betsy smiles a little and says: I'm glad we could use this set one last time. You even made Jasmine tea, my favorite.

* * *

>take the tea cup
You pour the tea from the kettle filling both cups. You gently lift the second cup of tea and hand it to Betsy. 

The wait is finally over, Betsy says enthusiastically. There's no one else I'd rather share it with. 
She holds out the decorative porcelain cup toward the center of the table. 
 "A toast to the end." 
 "A toast to the end" you reply. 
Betsy takes a drink of the tea and smiles.  
You hold the warm tea eager to take a  drink . You're excited to  ask Betsy  what she thinks   about the tea  .

>ask betsy what she thinks about the tea
There is no reply.

* * *

>take the tea cup
You pour the tea from the kettle filling both cups. You gently lift the second cup of tea and hand it to Betsy. 

The wait is finally over, Betsy says enthusiastically. There's no one else I'd rather share it with. 
She holds out the decorative porcelain cup toward the center of the table. 
 "A toast to the end." 
 "A toast to the end" you reply. 
Betsy takes a drink of the tea and smiles.  
You hold the warm tea eager to take a  drink . You're excited to  ask Betsy  what she thinks   about the tea  .

>take the tea
(the tea set)
You should probably  take the tea cup  out of the tea set first.

>take the tea set
You should probably  take the tea cup  out of the tea set first.

>take the window
Taken.

>take betsy
I don't suppose Betsy would care for that.

>hug betsy
You hug Betsy.

>take the table
That's hardly portable.

* * *

>take the tea cup
You pour the tea from the kettle filling both cups. You gently lift the second cup of tea and hand it to Betsy. 

The wait is finally over, Betsy says enthusiastically. There's no one else I'd rather share it with. 
She holds out the decorative porcelain cup toward the center of the table. 
 "A toast to the end." 
 "A toast to the end" you reply. 
Betsy takes a drink of the tea and smiles.  
You hold the warm tea eager to take a  drink . You're excited to  ask Betsy  what she thinks   about the tea  .

>please
Please do not say please.

>drink tea
(the tea set)
You can smell the faint aroma of jasmine. The steam rises off of the cup.  the tea tastes herbal and delicious.

[Your score has just gone up by one point.]

* * *

>talk to betsy
What would you like to talk to Betsy about? 
To start a conversation with Betsy, try to ASK Betsy ABOUT something or TELL Betsy ABOUT something.

>talk to betsy about the window
There is no reply.

>talk to betsy about tea
There is no reply.

>ask betsy about the tea
"How is the tea?" You ask. 

"Perfect. Even better than I expected. I've been thinking about it since the day we decided to store it. Betsy says joyfully, her smile beaming as she takes another sip. 

 "What do you think? Do you like it? She asks."  (Yes/No).

* * *

>talk to betsy
What would you like to talk to Betsy about? 
To start a conversation with Betsy, try to ASK Betsy ABOUT something or TELL Betsy ABOUT something.

>ask betsy about the window
There is no reply.

>ask betsy about the tea
"How is the tea?" You ask. 
"Perfect. Even better than I expected. I've been thinking about it since the day we decided to store it." Betsy says joyfully, her smile beaming as she takes another sip. 
 "What do you think? Do you like it? She asks." 

 (Yes/No).

>tell betsy about the tea
This provokes no reaction.

>i dont know
I only understood you as far as wanting to take inventory.

* * *

>talk to betsy
What would you like to talk to Betsy about? 
To start a conversation with Betsy, try to ASK Betsy ABOUT something or TELL Betsy ABOUT something.

>ask betsy about the tea
"How is the tea?" You ask. 
"Perfect. Even better than I expected. I've been thinking about it since the day we decided to store it." Betsy says joyfully, her smile beaming as she takes another sip. 
 "What do you think? Do you like it? She asks." 

 (Yes/No).

>no
"I've had better." Betsy looks down a little disappointed. 
"Well she says, I think there's still a bit of clean water left." You walk over to the small container of water, thinking about how you scraped together the little money you had left to get it. 
 Reflecting on the situation causes you to feel dejected. You decide it's better to focus on something else.

* * *

>look at window
You gaze out of the window. You stare into the desolate landscape that was once a flourishing garden years ago. The thick wall of polluted fog makes it impossible to see what may be in the distance. The crystal clear blue sky you remembered as a child is painted with toxic hues of grey and orange. Your chest tightens and your heart begins to sink.  

Betsy, noticing your despondent expression, gets up from her chair and places her hand on your shoulder. "I know what you're feeling. Let's make this day the best we can."

* * *

>open window
You place your fingers on the window locks. 

 Betsy jumps from her seat. "Woah hey! What are you doing!?" she exclaims. 

 You jolt back, retracting your hands from the window. 

 You feel like apologizing to Betsy for scaring her.

>ask betsy about window
There is no reply.

>ask betsy about the tea
"How is the tea?" You ask. 

"Perfect. Even better than I expected. I've been thinking about it since the day we decided to store it. Betsy says joyfully, her smile beaming as she takes another sip. 

 "What do you think? Do you like it? She asks."  (Yes/No).

* * *

>look at window
You gaze out of the window. You stare into the desolate landscape that was once a flourishing garden years ago. 
The thick wall of polluted fog makes it impossible to see what may be in the distance. The crystal clear blue sky you remembered as a child is painted with toxic hues of grey and orange. 
Your chest tightens and your heart begins to sink.  
Betsy, noticing your despondent expression, gets up from her chair. 
She places her hand on your shoulder and says: "I know what you're feeling. Let's make this day the best we can."

>open the window
You place your fingers on the window locks. 

 Betsy jumps from her seat. "Woah hey! What are you doing!?" she exclaims. 

 You jolt back, retracting your hands from the window. 

 You feel like apologizing to Betsy for scaring her.

>sorry
"I'm sorry I don't know what came over me. I didn't mean to worry you, it must be an old hab"- "hey you have nothing to apologize for" she interjects. What matters is that we're okay. This tea you made will make up for it" she laughs.  

 Betsy's light hearted response brings you back to a calmer place.  You look up from the table and give a warm "thanks."

>look at tea set
A hand-me-down tea set your grandma gave you for your birthday. You fixate on the fine paintings and details in the set, noticing the depictions of story book animals playing in the forest. 

 The imagery makes you long to  look at the window  and admire the nature around you. You look up to see Betsy eagerly waiting for a  cup  .

In the tea set is a tea cup.

>take tea cup
You pour the tea from the kettle filling both cups. You gently lift the second cup of tea and hand it to Betsy. 

 The wait is finally over, Betsy says enthusiastically. There's no one else I'd rather share it with. She holds out the decorative porcelain cup toward the center of the table. "A toast to the end."  "A toast to the end" you reply. Betsy takes a drink of the tea and smiles.  

 You hold the warm tea eager to take a  drink . You're excited to  ask Betsy  what she thinks   about the tea  .

>ask betsy what she thinks about the tea
There is no reply.

>ask betsy about the tea
"How is the tea?" You ask. 

"Perfect. Even better than I expected. I've been thinking about it since the day we decided to store it. Betsy says joyfully, her smile beaming as she takes another sip. 

 "What do you think? Do you like it? She asks."  (Yes/No).

>yes
"Yes. I love it!" 

 "I knew you would," said Betsy. "I'm going to miss stopping at that tea shop downtown on the way to class with you. That was one of my fondest memories. You helped me out through some tough times. I don't know how I could've made it without you."  

 "I feel the same way, I miss it all so much," you say, your eyes filling with tears. "thanks for always being there."

* * *

>no
"I've had better." Betsy looks down a little disappointed. "Well she says, I think there's still a bit of clean water left." You walk over to the small container of water, thinking about how you scraped together the little money you had left to get it. 

 Reflecting on the situation causes you to feel dejected. You decide it's better to focus on something else.

>look at Betst
You can't see any such thing.

>look at betsy
You notice your friend Betsy. Her presence puts you at ease and you consider approaching her to talk.

* * *

>look at window
You gaze out of the window. You stare into the desolate landscape that was once a flourishing garden years ago. 
The thick wall of polluted fog makes it impossible to see what may be in the distance. The crystal clear blue sky you remembered as a child is painted with toxic hues of grey and orange. 
Your chest tightens and your heart begins to sink.  
Betsy, noticing your despondent expression, gets up from her chair. 
She places her hand on your shoulder and says: "I know what you're feeling. Let's make this day the best we can."

>ask betsy about the tea
"How is the tea?" You ask. 
"Perfect. Even better than I expected. I've been thinking about it since the day we decided to store it." Betsy says joyfully, her smile beaming as she takes another sip. 
 "What do you think? Do you like it? She asks." 

 (Yes/No). 

 a light gets brighter

>ya
That's not a verb I recognize.

>yes
"Yes. I love it!" 
 "I knew you would," said Betsy. "I'm going to miss stopping at that tea shop downtown on the way to class with you. That was one of my fondest memories. You helped me out through some tough times. 
I don't know how I could've made it without you."  
 "I feel the same way, I miss it all so much," you say, your eyes filling with tears. "thanks for always being there." 

    *** Your heart beats strangely fast ***

In that game you scored 0 out of a possible 0, in 3 turns.

Would you like to RESTART, RESTORE a saved game, QUIT, or UNDO the last command?

* * *

>look at window
You gaze out of the window. You stare into the desolate landscape that was once a flourishing garden years ago. 
The thick wall of polluted fog makes it impossible to see what may be in the distance. The crystal clear blue sky you remembered as a child is painted with toxic hues of grey and orange. 
Your chest tightens and your heart begins to sink.  
Betsy, noticing your despondent expression, gets up from her chair. 
She places her hand on your shoulder and says: "I know what you're feeling. Let's make this day the best we can."

>look at betsy
You notice your friend Betsy. Her presence puts you at ease and you consider approaching her to talk. 
 You think about what you might want to  ask Betsy about something  to start a conversation.

>ask betsy about tea
"How is the tea?" You ask. 
"Perfect. Even better than I expected. I've been thinking about it since the day we decided to store it." Betsy says joyfully, her smile beaming as she takes another sip. 
 "What do you think? Do you like it? She asks." 

 (Yes/No).

>take tea
(the tea set)
You should probably  take the tea cup  out of the tea set first.

>no
"I've had better." 
Betsy looks down a little disappointed. 
"Well she says, I think there's still a bit of clean water left." 
You walk over to the small container of water, thinking about how you scraped together the little money you had left to get it. 
 Reflecting on the situation causes you to feel dejected. 
You decide it might be better to focus on something else.

>yes
"Yes. I love it!" 
 "I knew you would," said Betsy. "I'm going to miss stopping at that tea shop downtown on the way to class with you. That was one of my fondest memories. You helped me out through some tough times. 
I don't know how I could've made it without you."  
 "I feel the same way, I miss it all so much," you say, your eyes filling with tears. "thanks for always being there."

>sorry
"I'm sorry I don't know what came over me. I didn't mean to worry you, it must be an old hab"- "hey you have nothing to apologize for" she interjects. 
What matters is that we're okay. This tea you made will make up for it" she laughs.  
 Betsy's light hearted response brings you back to a calmer place.  You look up from the table and give a warm "thanks."

>open window
You place your fingers on the window locks. 
 Betsy jumps from her seat. "Woah hey! What are you doing!?" she exclaims. 
 You jolt back, retracting your hands from the window. 

 You feel like you should  tell Betsy sorry  for scaring her. 
The light outside the window gets brighter and begins to fill the room. You and Betsy look at another knowingly. The moment has come. As you meet for one last embrace you remember the life you lived and how grateful you are to have had someone special to share in those moments with you.

    *** You have completed the game ***

In that game you scored 0 out of a possible 0, in 8 turns.

Would you like to RESTART, RESTORE a saved game, QUIT, or UNDO the last command?

* * *

>look out window
I only understood you as far as wanting to look outside.

>look outside
You see nothing unexpected in that direction.

>look window
You gaze out of the window. You stare into the desolate landscape that was once a flourishing garden years ago. The thick wall of polluted fog makes it impossible to see what may be in the distance. The crystal clear blue sky you remembered as a child is painted with toxic hues of grey and orange. Your chest tightens and your heart begins to sink.  

Betsy, noticing your despondent expression, gets up from her chair and places her hand on your shoulder. "I know what you're feeling. Let's make this day the best we can."

>talk betsy
I didn't understand that sentence.

>ask betsy
What do you want to ask Betsy for?

>help
There is no reply.

>ask betsy
What do you want to ask Betsy for?

>opinion
There is no reply.

>talk to betsy
I didn't understand that sentence.

>hey betsy
That's not a verb I recognize.

>look at tea set
A hand-me-down tea set your grandma gave you for your birthday. You fixate on the fine paintings and details in the set, noticing the depictions of story book animals playing in the forest. 

 The imagery makes you long to  look at the window  and admire the nature around you. You look up to see Betsy eagerly waiting for a  cup  .

In the tea set is a tea cup.

>fill tea cup
That's not a verb I recognize.

>make tea
That's not a verb I recognize.

>tea cup
That's not a verb I recognize.

>drink tea
(the tea set)
You can smell the faint aroma of jasmine. The steam rises off of the cup.  the tea tastes herbal and delicious.

>talk betsy
I didn't understand that sentence.

* * *

>ask betsy
What do you want to ask Betsy for?

>talk to betsy
I didn't understand that sentence.

>Talk to Betsy.
There is no reply.

>ask betsy tea
"How is the tea?" You ask. 

"Perfect. Even better than I expected. I've been thinking about it since the day we decided to store it. Betsy says joyfully, her smile beaming as she takes another sip. 

 "What do you think? Do you like it? She asks."  (Yes/No).

>yes
"Yes. I love it!" 

 "I knew you would," said Betsy. "I'm going to miss stopping at that tea shop downtown on the way to class with you. That was one of my fondest memories. You helped me out through some tough times. I don't know how I could've made it without you."  

 "I feel the same way, I miss it all so much," you say, your eyes filling with tears. "thanks for always being there."

>ask betsy window
There is no reply.

>open window
You place your fingers on the window locks. 

 Betsy jumps from her seat. "Woah hey! What are you doing!?" she exclaims. 

 You jolt back, retracting your hands from the window. 

 You feel like apologizing to Betsy for scaring her.

>apologize to Betsy
That's not a verb I recognize.

>sorry
"I'm sorry I don't know what came over me. I didn't mean to worry you, it must be an old hab"- "hey you have nothing to apologize for" she interjects. What matters is that we're okay. This tea you made will make up for it" she laughs.  

 Betsy's light hearted response brings you back to a calmer place.  You look up from the table and give a warm "thanks."

>hug betsy
Betsy might not like that.

>throw tea set
The tea set is already here.

>drink tea
(the tea set)
You can smell the faint aroma of jasmine. The steam rises off of the cup.  the tea tastes herbal and delicious.

>ask betsy past
There is no reply.

* * *

>talk to betsy about the tea set
There is no reply.

>talk to betsy about the tea
"How is the tea?" You ask. 

"Perfect. Even better than I expected. I've been thinking about it since the day we decided to store it. Betsy says joyfully, her smile beaming as she takes another sip. 

 "What do you think? Do you like it? She asks."  (Yes/No).

* * *

>tell betsy about the tea
This provokes no reaction.

>talk to betsy about the tea
"How is the tea?" You ask. 

"Perfect. Even better than I expected. I've been thinking about it since the day we decided to store it. Betsy says joyfully, her smile beaming as she takes another sip. 

 "What do you think? Do you like it? She asks."  (Yes/No).

* * *

>pouring tea
(the tea set)
Taken.

* * *

>talk to betsy about the window
There is no reply.

* * *

>take the cup
You pour the tea from the kettle filling both cups. You gently lift the second cup of tea and hand it to Betsy. 

 The wait is finally over, Betsy says enthusiastically. There's no one else I'd rather share it with. She holds out the decorative porcelain cup toward the center of the table. "A toast to the end."  "A toast to the end" you reply. Betsy takes a drink of the tea and smiles.  

 You hold the warm tea eager to take a  drink . You're excited to  ask Betsy  what she thinks   about the tea  .

>pour cup
You pour the tea from the kettle filling both cups. You gently lift the second cup of tea and hand it to Betsy. 

 The wait is finally over, Betsy says enthusiastically. There's no one else I'd rather share it with. She holds out the decorative porcelain cup toward the center of the table. "A toast to the end."  "A toast to the end" you reply. Betsy takes a drink of the tea and smiles.  

 You hold the warm tea eager to take a  drink . You're excited to  ask Betsy  what she thinks   about the tea  .

* * *

>squeeze betsy
You hug Betsy.

* * *

>embrace betsy
That's not a verb I recognize.

* * *

>hug betsy
You hug Betsy.

>throw tea
(the tea set)
The tea set is already here.

>throw the tea set
The tea set is already here.

* * *

>hug betsy
You hug Betsy.

>show score
You can't see any such thing.

>squeeze betsy
You hug Betsy.

>hug betsy
You hug Betsy.

>hug betsy
You hug Betsy.

>take the tea
(the tea set)
You should probably  take the tea cup  out of the tea set first.

>please
Please do not say please.

>take the tea set
You should probably  take the tea cup  out of the tea set first.

>take the tea cup
You pour the tea from the kettle filling both cups. You gently lift the second cup of tea and hand it to Betsy. 

The wait is finally over, Betsy says enthusiastically. There's no one else I'd rather share it with. 
She holds out the decorative porcelain cup toward the center of the table. 
 "A toast to the end." 
 "A toast to the end" you reply. 
Betsy takes a drink of the tea and smiles.  
You hold the warm tea eager to take a  drink . You're excited to  ask Betsy  what she thinks   about the tea  .

>drink the tea
(the tea set)
You can smell the faint aroma of jasmine. The steam rises off of the cup.  the tea tastes herbal and delicious.

* * *

>throw tea at betsy
(the tea set at Betsy)
why.

(first taking the tea set)
You lack the nerve when it comes to the crucial moment.

* * *

>throw tea
(the tea set)
 To throw the tea set  try instead "throw the tea set AT something."

>ask betsy about the window
There is no reply.

>ask betsy about the tea
"How is the tea?" You ask. 

"Perfect. Even better than I expected. I've been thinking about it since the day we decided to store it. Betsy says joyfully, her smile beaming as she takes another sip. 

 "What do you think? Do you like it? She asks."  (Yes/No).

* * *

>pour the tea
(the tea set)
Taken.

* * *

>throw the tea
(the tea set)
 To throw the tea set  try instead "throw the tea set AT something."

>throw the tea at the table
(the tea set at the table)
Why would you do that?

(first taking the tea set)
You should probably  take the tea cup  out of the tea set first.

>throw the tea at the wall
You can't see any such thing.

>throw the tea at the ground
You can't see any such thing.

>drop the tea
(the tea set)
 To throw the tea set  try instead "throw the tea set AT something."

>look at the window
You gaze out of the window. You stare into the desolate landscape that was once a flourishing garden years ago. The thick wall of polluted fog makes it impossible to see what may be in the distance. The crystal clear blue sky you remembered as a child is painted with toxic hues of grey and orange. Your chest tightens and your heart begins to sink.  

Betsy, noticing your despondent expression, gets up from her chair and places her hand on your shoulder. "I know what you're feeling. Let's make this day the best we can."

* * *

>please
That's not a verb I recognize.

>please
That's not a verb I recognize.

>please
Please do not say please.

* * *

>take the tea
(the tea set)
You should probably  take the tea cup  out of the tea set first.

>take the window
Taken.

[Your score has just gone up by one point.]

>take tea
(the tea set)
You should probably  take the tea cup  out of the tea set first.

>drink tea
(the tea set)
You can smell the faint aroma of jasmine. The steam rises off of the cup.  the tea tastes herbal and delicious.

>take betsy
I don't suppose Betsy would care for that.

>take table
That's hardly portable.

>take window
You already have that.

>take tea set
You should probably  take the tea cup  out of the tea set first.

>take tea cup
You pour the tea from the kettle filling both cups. You gently lift the second cup of tea and hand it to Betsy. 

The wait is finally over, Betsy says enthusiastically. There's no one else I'd rather share it with. 
She holds out the decorative porcelain cup toward the center of the table. 
 "A toast to the end." 
 "A toast to the end" you reply. 
Betsy takes a drink of the tea and smiles.  
You hold the warm tea eager to take a  drink . You're excited to  ask Betsy  what she thinks   about the tea  .

>take tea cup
You pour the tea from the kettle filling both cups. You gently lift the second cup of tea and hand it to Betsy. 

The wait is finally over, Betsy says enthusiastically. There's no one else I'd rather share it with. 
She holds out the decorative porcelain cup toward the center of the table. 
 "A toast to the end." 
 "A toast to the end" you reply. 
Betsy takes a drink of the tea and smiles.  
You hold the warm tea eager to take a  drink . You're excited to  ask Betsy  what she thinks   about the tea  .

* * *

>take the window
Taken.

[Your score has just gone up by one point.]

>drink the tea
(the tea set)
You can smell the faint aroma of jasmine. The steam rises off of the cup.  the tea tastes herbal and delicious.

>drink the tea
(the tea set)
You can smell the faint aroma of jasmine. The steam rises off of the cup.  the tea tastes herbal and delicious.

>take the window
You already have that.

>show score
You can't see any such thing.

>full
So far you have received points for the following: 

  taking the window: 1 points

* * *

>take the tea
(the tea set)
You should probably  take the tea cup  out of the tea set first.

>take tea cup
You pour the tea from the kettle filling both cups. You gently lift the second cup of tea and hand it to Betsy. 

The wait is finally over, Betsy says enthusiastically. There's no one else I'd rather share it with. 
She holds out the decorative porcelain cup toward the center of the table. 
 "A toast to the end." 
 "A toast to the end" you reply. 
Betsy takes a drink of the tea and smiles.  
You hold the warm tea eager to take a  drink . You're excited to  ask Betsy  what she thinks   about the tea  .

>take window
Taken.

[Your score has just gone up by five points.]

>take the tea cup
You pour the tea from the kettle filling both cups. You gently lift the second cup of tea and hand it to Betsy. 

The wait is finally over, Betsy says enthusiastically. There's no one else I'd rather share it with. 
She holds out the decorative porcelain cup toward the center of the table. 
 "A toast to the end." 
 "A toast to the end" you reply. 
Betsy takes a drink of the tea and smiles.  
You hold the warm tea eager to take a  drink . You're excited to  ask Betsy  what she thinks   about the tea  .

>take the tea set
You should probably  take the tea cup  out of the tea set first.

* * *

>take the tea set
You should probably  take the tea cup  out of the tea set first.

* * *

>take the tea cup
You pour the tea from the kettle filling both cups. You gently lift the second cup of tea and hand it to Betsy. 

The wait is finally over, Betsy says enthusiastically. There's no one else I'd rather share it with. 
She holds out the decorative porcelain cup toward the center of the table. 
 "A toast to the end." 
 "A toast to the end" you reply. 
Betsy takes a drink of the tea and smiles.  
You hold the warm tea eager to take a  drink . You're excited to  ask Betsy  what she thinks   about the tea  .

>take the window
the sky gets a little brighter.

[Your score has just gone up by one point.]

* * *

>please
Please do not say please.

>please
Please do not say please.

>take the tea cup
You pour the tea from the kettle filling both cups. You gently lift the second cup of tea and hand it to Betsy. 

The wait is finally over, Betsy says enthusiastically. There's no one else I'd rather share it with. 
She holds out the decorative porcelain cup toward the center of the table. 
 "A toast to the end." 
 "A toast to the end" you reply. 
Betsy takes a drink of the tea and smiles.  
You hold the warm tea eager to take a  drink . You're excited to  ask Betsy  what she thinks   about the tea  .

Truly, Solomon has answered all your questions, and his wisdom is even as great as you had heard!

    *** Your heart beats strangely fast ***

In that game you scored 3 out of a possible 0, in 1 turn.

Would you like to RESTART, RESTORE a saved game, QUIT, or UNDO the last command?

>restart
It's finally here. The news channels have stopped broadcasting. Every person is finding their way to the place they want to be when it happens. The notifications on your phone haven't stopped since the news broke, as friends and family send you the last thoughts they want to share before they no longer can. 

Your apartment doesn't feel the same anymore. 
The  windows  locked, curtains drawn. You're overwhelmed with dread at the thought of opening them. Glancing toward the kitchen table your eyes rest on your grandmother's  tea set . 
You feel  broken-hearted  at the sight and consider how she might have handled this situation. You realize you don't have to wonder. She likely would have handled this the same way she handled her passing. She would have sipped her tea and waited for her time to come, humming hymns all the while. 
You notice your friend  Betsy . Her presence puts you  at ease  and you consider approaching her to talk. 

 You know your time is limited so you decide to spend it with care.

Go Down Together
An Interactive Fiction by Kiersten
Release 1 / Serial number 210904 / Inform 7 build 6M62 (I6/v6.33 lib 6/12N) SD

dining room
You sit at a table in a small dining room with your best friend, Betsy, sitting across from you.

There is a small window locked shut. It looks like it hasn't been opened in years.

Betsy sits quietly at the table. She stares off into the distance looking lost in thought.

You can also see a tea set (in which is a tea cup) here.

>take the tea cup
You pour the tea from the kettle filling both cups. You gently lift the second cup of tea and hand it to Betsy. 

The wait is finally over, Betsy says enthusiastically. There's no one else I'd rather share it with. 
She holds out the decorative porcelain cup toward the center of the table. 
 "A toast to the end." 
 "A toast to the end" you reply. 
Betsy takes a drink of the tea and smiles.  
You hold the warm tea eager to take a  drink . You're excited to  ask Betsy  what she thinks   about the tea  .

>take the tea cup
You pour the tea from the kettle filling both cups. You gently lift the second cup of tea and hand it to Betsy. 

The wait is finally over, Betsy says enthusiastically. There's no one else I'd rather share it with. 
She holds out the decorative porcelain cup toward the center of the table. 
 "A toast to the end." 
 "A toast to the end" you reply. 
Betsy takes a drink of the tea and smiles.  
You hold the warm tea eager to take a  drink . You're excited to  ask Betsy  what she thinks   about the tea  .

* * *

>please
Please do not say please.

>take the tea cup
You pour the tea from the kettle filling both cups. You gently lift the second cup of tea and hand it to Betsy. 

The wait is finally over, Betsy says enthusiastically. There's no one else I'd rather share it with. 
She holds out the decorative porcelain cup toward the center of the table. 
 "A toast to the end." 
 "A toast to the end" you reply. 
Betsy takes a drink of the tea and smiles.  
You hold the warm tea eager to take a  drink . You're excited to  ask Betsy  what she thinks   about the tea  .

Truly, Solomon has answered all your questions, and his wisdom is even as great as you had heard!

    *** Your heart beats strangely fast ***

In that game you scored 3 out of a possible 0, in 4 turns.

Would you like to RESTART, RESTORE a saved game, QUIT, or UNDO the last command?

>restart
It's finally here. The news channels have stopped broadcasting. Every person is finding their way to the place they want to be when it happens. The notifications on your phone haven't stopped since the news broke, as friends and family send you the last thoughts they want to share before they no longer can. 

Your apartment doesn't feel the same anymore. 
The  windows  locked, curtains drawn. You're overwhelmed with dread at the thought of opening them. Glancing toward the kitchen table your eyes rest on your grandmother's  tea set . 
You feel  broken-hearted  at the sight and consider how she might have handled this situation. You realize you don't have to wonder. She likely would have handled this the same way she handled her passing. She would have sipped her tea and waited for her time to come, humming hymns all the while. 
You notice your friend  Betsy . Her presence puts you  at ease  and you consider approaching her to talk. 

 You know your time is limited so you decide to spend it with care.

Go Down Together
An Interactive Fiction by Kiersten
Release 1 / Serial number 210904 / Inform 7 build 6M62 (I6/v6.33 lib 6/12N) SD

dining room
You sit at a table in a small dining room with your best friend, Betsy, sitting across from you.

There is a small window locked shut. It looks like it hasn't been opened in years.

Betsy sits quietly at the table. She stares off into the distance looking lost in thought.

You can also see a tea set (in which is a tea cup) here.

>please
Please do not say please.

>take the tea cup
You pour the tea from the kettle filling both cups. You gently lift the second cup of tea and hand it to Betsy. 

The wait is finally over, Betsy says enthusiastically. There's no one else I'd rather share it with. 
She holds out the decorative porcelain cup toward the center of the table. 
 "A toast to the end." 
 "A toast to the end" you reply. 
Betsy takes a drink of the tea and smiles.  
You hold the warm tea eager to take a  drink . You're excited to  ask Betsy  what she thinks   about the tea  .

[Your score has just gone up by one point.]

>take the tea cup
You pour the tea from the kettle filling both cups. You gently lift the second cup of tea and hand it to Betsy. 

The wait is finally over, Betsy says enthusiastically. There's no one else I'd rather share it with. 
She holds out the decorative porcelain cup toward the center of the table. 
 "A toast to the end." 
 "A toast to the end" you reply. 
Betsy takes a drink of the tea and smiles.  
You hold the warm tea eager to take a  drink . You're excited to  ask Betsy  what she thinks   about the tea  .

* * *

>please
Please do not say please.

>take the tea cup
You pour the tea from the kettle filling both cups. You gently lift the second cup of tea and hand it to Betsy. 

The wait is finally over, Betsy says enthusiastically. There's no one else I'd rather share it with. 
She holds out the decorative porcelain cup toward the center of the table. 
 "A toast to the end." 
 "A toast to the end" you reply. 
Betsy takes a drink of the tea and smiles.  
You hold the warm tea eager to take a  drink . You're excited to  ask Betsy  what she thinks   about the tea  .

[Your score has just gone up by three points.]

>please
Please do not say please.

* * *

>take the tea cup
You pour the tea from the kettle filling both cups. You gently lift the second cup of tea and hand it to Betsy. 

The wait is finally over, Betsy says enthusiastically. There's no one else I'd rather share it with. 
She holds out the decorative porcelain cup toward the center of the table. 
 "A toast to the end." 
 "A toast to the end" you reply. 
Betsy takes a drink of the tea and smiles.  
You hold the warm tea eager to take a  drink . You're excited to  ask Betsy  what she thinks   about the tea  .

>drink tea
(the tea set)
You can smell the faint aroma of jasmine. The steam rises off of the cup.  the tea tastes herbal and delicious.

>take the tea set
You should probably  take the tea cup  out of the tea set first.

* * *

>please
Please do not say please.

>take the tea
(the tea set)
You should probably  take the tea cup  out of the tea set first.

Truly, Solomon has answered all your questions, and his wisdom is even as great as you had heard!

    *** Your heart beats strangely fast ***

In that game you scored 1 out of a possible 0, in 1 turn.

Would you like to RESTART, RESTORE a saved game, QUIT, or UNDO the last command?

* * *

>shwo score
That's not a verb I recognize.

>show score
You can't see any such thing.

* * *

>show score
You can't see any such thing.

>full score
You have not yet achieved anything of note.

>open the window
You place your fingers on the window locks. 
 Betsy jumps from her seat. "Woah hey! What are you doing!?" she exclaims. 
 You jolt back, retracting your hands from the window. 

 You feel like you should  tell Betsy sorry  for scaring her. 
[Your score has just gone up by one point.]

>check the score
You can't see any such thing.

* * *

>look tea sea
You can't see any such thing.

>look tea set
A hand-me-down tea set your grandma gave you for your birthday. You fixate on the fine paintings and details in the set, noticing the depictions of story book animals playing in the forest. 

 The imagery makes you long to  look at the window  and admire the nature around you. You look up to see Betsy eagerly waiting for you to  take the tea cup   and pour her some.

In the tea set is a tea cup.

>take the tea cu
You can't see any such thing.

>take the tea cup
You pour the tea from the kettle filling both cups. You gently lift the second cup of tea and hand it to Betsy. 

The wait is finally over, Betsy says enthusiastically. There's no one else I'd rather share it with. 
She holds out the decorative porcelain cup toward the center of the table. 
 "A toast to the end." 
 "A toast to the end" you reply. 
Betsy takes a drink of the tea and smiles.  
You hold the warm tea eager to take a  drink . You're excited to  ask Betsy  what she thinks   about the tea  .

>about the tea
That's not a verb I recognize.

>ask about the tea
You can't see any such thing.

>ask betsy about the tea
"How is the tea?" You ask. 
"Perfect. Even better than I expected. I've been thinking about it since the day we decided to store it." Betsy says joyfully, her smile beaming as she takes another sip. 
 "What do you think? Do you like it? She asks." 

 (Yes/No).

>yes
"Yes. I love it!" 
 "I knew you would," said Betsy. "I'm going to miss stopping at that tea shop downtown on the way to class with you. That was one of my fondest memories. You helped me out through some tough times. 
I don't know how I could've made it without you."  
 "I feel the same way, I miss it all so much," you say, your eyes filling with tears. "thanks for always being there."

>look at the window
You gaze out of the window. You stare into the desolate landscape that was once a flourishing garden years ago. 
The thick wall of polluted fog makes it impossible to see what may be in the distance. The crystal clear blue sky you remembered as a child is painted with toxic hues of grey and orange. 
Your chest tightens and your heart begins to sink.  
Betsy, noticing your despondent expression, gets up from her chair. 
She places her hand on your shoulder and says: "I know what you're feeling. Let's make this day the best we can."

>throw tea set
To throw the tea set  try instead "throw the tea set AT something."

>throw tea set at wall
You can't see any such thing.

>throw tea set at window
Why would you do that?

(first taking the tea set)
You should probably  take the tea cup  out of the tea set first.

>ask betsy
What do you want to ask Betsy for?

>ask betsy about the window
There is no reply.

>ask betsy about betsy
There is no reply.

The light outside the window gets brighter and begins to fill the room. 
You and Betsy look at another knowingly. The moment has come. 
As you meet for one last embrace you remember the life you lived and how grateful you are to have had someone special to share in those moments with you.

    *** You have completed the game ***

Would you like to RESTART, RESTORE a saved game, QUIT, or UNDO the last command?

>restart
It's finally here. The news channels have stopped broadcasting. Every person is finding their way to the place they want to be when it happens. The notifications on your phone haven't stopped since the news broke, as friends and family send you the last thoughts they want to share before they no longer can. 

Your apartment doesn't feel the same anymore. 
The  windows  locked, curtains drawn. You're overwhelmed with dread at the thought of opening them. Glancing toward the kitchen table your eyes rest on your grandmother's  tea set . 
You feel  broken-hearted  at the sight and consider how she might have handled this situation. You realize you don't have to wonder. She likely would have handled this the same way she handled her passing. She would have sipped her tea and waited for her time to come, humming hymns all the while. 
You notice your friend  Betsy . Her presence puts you  at ease  and you consider approaching her to talk. 

 You know your time is limited so you decide to spend it with care.

Go Down Together
An Interactive Fiction by Kiersten
Release 1 / Serial number 210904 / Inform 7 build 6M62 (I6/v6.33 lib 6/12N) SD

dining room
You sit at a table in a small dining room with your best friend, Betsy, sitting across from you.

There is a small window locked shut. It looks like it hasn't been opened in years.

Betsy sits quietly at the table. She stares off into the distance looking lost in thought.

You can also see a tea set (in which is a tea cup) here.

>ask betsy about the tea
"How is the tea?" You ask. 
"Perfect. Even better than I expected. I've been thinking about it since the day we decided to store it." Betsy says joyfully, her smile beaming as she takes another sip. 
 "What do you think? Do you like it? She asks." 

 (Yes/No).

* * *

>make tesa
That's not a verb I recognize.

>make tea
That's not a verb I recognize.

>look tea set
A hand-me-down tea set your grandma gave you for your 18th birthday. You fixate on the fine line work, examining the depictions of story book animals playing in the forest. 

 As you ponder the depictions of nature, you long to  look at the window . You look up to see Betsy eagerly waiting for you to  take the tea cup   and pour hers.

In the tea set is a tea cup.

>take the tea cup
You pour the tea from the kettle filling both cups. You gently lift the second cup of tea and hand it to Betsy. 

"The wait is finally over," Betsy sighs. "I'm glad I got to spend it with you." She holds out the decorative porcelain cup toward the center of the table. "A toast to the end."  "A toast to the end" you relent. 
Betsy takes a drink of the tea and smirks.  
You think about taking a  drink . You want to  ask Betsy  how she feels  about the tea  .

>drink
What do you want to drink?

>drink tea
(the tea set)
You smell the familiar aroma of jasmine, Betsy's favorite. The steam rises off of the cup.   the herbal flavors induce a calm you haven't felt for a long time.

>ask betsy about the tea
"How is the tea?" You ask. 
"Perfect. Even better than I expected. I've been thinking about it since the day the day we put it in storage." Betsy says joyfully, her smile beaming as she takes another sip. 
 "What do you think? Do you like it? She asks." 

 (Yes/No).

>yes
"Yeah, it's perfect." 
 "It's a classic," Betsy states. 
"I'm going to miss stopping at that tea shop downtown on the way to class with you. That was one of my fondest memories.
It got me through some tough times. I don't know how I could've made it without you." 
  "I feel the same way, I miss it all so much" you say, your eyes filling with tears. "It helped me too. I wish I had told you that more often."

>look at betsy
You notice your friend Betsy. Her presence puts you at ease and you consider approaching her to talk. 
 You think about what you might want to  ask Betsy about something  to start a conversation.

>ask betsy about tea
"How is the tea?" You ask. 
"Perfect. Even better than I expected. I've been thinking about it since the day the day we put it in storage." Betsy says joyfully, her smile beaming as she takes another sip. 
 "What do you think? Do you like it? She asks." 

 (Yes/No).

>no
"I've had better." 
Betsy looks down a little disappointed. 
"Well she says, I think there's still a bit of clean water left." 
You walk over to the small container of water, thinking about how you scraped together the little money you had left to buy. 
 Reflecting on the situation causes you to feel defeated. 
You decide it's better to focus on something else. 

The light outside the window gets brighter and begins to fill the room. 
You and Betsy look at one another knowingly. 
You embrace one another and tell each other stories about the life you lived and how grateful you are to have had someone so special to share those moments with. 
The ground begins to shake. The noise outside overwhelms the conversation.
You focus on Betsy and she focuses on you. You exchange a knowing glance with one another, nod, and close your eyes. Whatever happened in the next few minutes, you knew you'd be okay as long as you went through it together.

    *** You have completed the game ***

Would you like to RESTART, RESTORE a saved game, QUIT, or UNDO the last command?